"filename", "language", "TypeScript", "SCSS", "HTML", "comment", "blank", "total"
"c:\Users\n-chinh_zd\AWAG_DEPLOY\src\app\maintenance\maintenance-land\maintenance-land-config.ts", "TypeScript", -7, 0, 0, -5, -2, -14
"c:\Users\n-chinh_zd\AWAG_DEPLOY\src\app\maintenance\maintenance-land\maintenance-land-custom.component.scss", "SCSS", 0, -68, 0, -7, -22, -97
"c:\Users\n-chinh_zd\AWAG_DEPLOY\src\app\maintenance\maintenance-land\maintenance-land-custom.component.ts", "TypeScript", -13, 0, 0, -38, -6, -57
"c:\Users\n-chinh_zd\AWAG_DEPLOY\src\app\maintenance\maintenance-land\maintenance-land.component.html", "HTML", 0, 0, -179, -39, -1, -219
"c:\Users\n-chinh_zd\AWAG_DEPLOY\src\app\maintenance\maintenance-land\maintenance-land.component.ts", "TypeScript", -289, 0, 0, -247, -48, -584
"c:\Users\n-chinh_zd\AWAG_DEPLOY\src\app\maintenance\maintenance-land\service\maintenance-land-awaginit-custom.service.ts", "TypeScript", -5, 0, 0, -17, -5, -27
"c:\Users\n-chinh_zd\AWAG_DEPLOY\src\app\maintenance\maintenance-land\service\maintenance-land-awaginit.service.ts", "TypeScript", -23, 0, 0, -21, -5, -49
"c:\Users\n-chinh_zd\AWAG_DEPLOY\src\app\maintenance\maintenance-land\service\maintenance-land-awagsearch-custom.service.ts", "TypeScript", -5, 0, 0, -17, -5, -27
"c:\Users\n-chinh_zd\AWAG_DEPLOY\src\app\maintenance\maintenance-land\service\maintenance-land-awagsearch.service.ts", "TypeScript", -23, 0, 0, -21, -5, -49
"c:\Users\n-chinh_zd\AWAG_DEPLOY\src\app\maintenance\maintenance-land\service\maintenance-land-transportdeptonchange-custom.service.ts", "TypeScript", -5, 0, 0, -17, -5, -27
"c:\Users\n-chinh_zd\AWAG_DEPLOY\src\app\maintenance\maintenance-land\service\maintenance-land-transportdeptonchange.service.ts", "TypeScript", -23, 0, 0, -21, -5, -49
"c:\Users\n-chinh_zd\AWAG_DEPLOY\src\app\maintenance\maintenance.module.ts", "TypeScript", -13, 0, 0, -1, -4, -18
"Total", "-", -406, -68, -179, -451, -113, -1217